Feature ID	Taxon	Confidence
TACAGAGGGTGCAAGCGTTAATCGGATTTACTGGGCGTAAAGCGCGCGTAGGCGGCTAATTAAGTCAAATGTGAAATCCCCGAGCTTAACTTGGGAATTGCATTCGATACTGGTTAGCTAGAGTGTGGGAGAGGATGGTAGAATTCCAGG	d__Bacteria; p__Proteobacteria; c__Gammaproteobacteria; o__Pseudomonadales_660879; f__Moraxellaceae; g__Acinetobacter; s__Acinetobacter calcoaceticus	1.0
TACGTAGGGGGCTAGCGTTGTCCGGAATCACTGGGCGTAAAGGGTTCGCAGGCGGAAATGCAAGTCAGATGTAAAAGGCAGTAGCTTAACTACTGTAAGCATTTGAAACTGCATATCTTGAGAAGAGTAGAGGTAAGTGGAATTTTTAGT	d__Bacteria; p__Firmicutes_A; c__Clostridia_258483; o__Tissierellales; f__Peptoniphilaceae; g__Peptoniphilus_A; s__Peptoniphilus_A senegalensis	1.0
TACAGAGGGTGCAAGCGTTAATCGGATTTACTGGGCGTAAAGCGTACGTAGGCGGCTAATTAAGTCGGATGTGAAATCCCCGAGCTCAACTTGGGAATTGCATTCGATACTGGTTAGCTAGAGTATGGGAGAGGATGGTAGAATTCCAGG	d__Bacteria; p__Proteobacteria; c__Gammaproteobacteria; o__Pseudomonadales_660879; f__Moraxellaceae; g__Acinetobacter; s__	1.0
TACGTAGGGGGCGAGCGTTGTCCGGAATTATTGGGCGTAAAGGGTTCGCAGGCGGAAATATAAGTCAGGTGTAAAAGGCGGAGGCTCAACCTCCGTAAGCATTTGAAACTATATTTCTTGAGATATGGAGAGGTAAGTGGAATTCCTAGT	d__Bacteria; p__Firmicutes_A; c__Clostridia_258483; o__Tissierellales; f__Peptoniphilaceae; g__; s__	1.0
TACGGAGGGTGCAAGCGTTAATCGGAATTACTGGGCGTAAAGGGCGCGTAGGTGGTATCTTAAGTTGGGTGTGAAATCCCCGGGCTCAACCTGGGAATTGCATCCAAAACTGGGGTGCTAGAGTGTGGTAGAGGGTAGCGGAATTTCTGG	d__Bacteria; p__Proteobacteria; c__Gammaproteobacteria; o__Cardiobacteriales; f__Wohlfahrtiimonadaceae; g__Ignatzschineria; s__Ignatzschineria indica	1.0
TACGGAGGATCCGAGCGTTATCCGGATTTATTGGGTTTAAAGGGTGCGTAGGCGGACTGGAAAGTCAGCTGTGAAAGTTTGTGGCTCAACCACGAAATTGCAGTTGAAACTGTCGGTCTTGAGTATACATGAGGTGAGCGGAATTTGTGG	d__Bacteria; p__Bacteroidota; c__Bacteroidia; o__Bacteroidales; f__Bacteroidaceae; g__Bacteroides_E; s__	1.0
TACGGGGGGTGCAAGCGTTAATCGGAATTACTGGGCGTAAAGGGCGCGTAGGCGGTTACTTAAGTTAGATGTGAAAGCCCCGGGCTTAACCTGGGAATTGCATTTAATACTGGGTAACTAGAGTGTGGTAGAGAGTAGCGGAATTTCTGG	d__Bacteria; p__Proteobacteria; c__Gammaproteobacteria; o__Cardiobacteriales; f__Wohlfahrtiimonadaceae; g__Wohlfahrtiimonas; s__Wohlfahrtiimonas chitiniclastica	1.0
TACGGAGGATCCAAGCGTTATCCGGATTTATTGGGTTTAAAGGGTGCGTAGGCGGACTGGTAAGTCAGCTGTGAAAGTTTGCGGCTTAACCGTAAAATTGCAGTTGATACTGTCAGTCTTGAGTGTGCATGAGGTGGGCGGAATTTGTGG	d__Bacteria; p__Bacteroidota; c__Bacteroidia; o__Bacteroidales; f__Bacteroidaceae; g__Bacteroides_H; s__Bacteroides_H neonati	1.0
TACGTAGGTGGCAAGCGTTGTCCGGATTTATTGGGCGTAAAGCGAGCGCAGGCGGTTTCTTAAGTCTGATGTGAAAGCCCTCGGCTCAACCGAGGAAGGTCATTGGAAACTGGGGAACTTGAGTGCAGAAGAGGAGAGTGGAATTCCATG	d__Bacteria; p__Firmicutes_D; c__Bacilli; o__Lactobacillales; f__Vagococcaceae; g__Vagococcus_B; s__Vagococcus_B carniphilus	1.0
TACGGAGGATCCGAGCGTTATCCGGATTTATTGGGTTTAAAGGGTGCGTAGGCGGACTGGTAAGTCAGCTGTGAAAGTTTACGGCTCAACCGTGAAATTGCAGTTGATACTGTTGGTCTTGAGTATACATGAGGTGGGCGGAATTTGTGG	d__Bacteria; p__Bacteroidota; c__Bacteroidia; o__Bacteroidales; f__Bacteroidaceae; g__Bacteroides_H; s__	1.0
TACGTAGGTGGCAAGCGTTGTCCGGATTTATTGGGCGTAAAGCGAGCGCAGGCGGTCTTTTAAGTCTGATGTGAAAGCCCTCGGCTCAACCGAGGAAGGTCATTGGAAACTGGAAGACTTGAGTGCAGAAGAGGAGAGTGGAATTCCATG	d__Bacteria; p__Firmicutes_D; c__Bacilli; o__Lactobacillales; f__Vagococcaceae; g__Vagococcus_B; s__	1.0
TACGGAGGATCCGAGCGTTATCCGGATTTATTGGGTTTAAAGGGTGCGTAGGCGGACTGATAAGTCAGCTGTGAAAGTTTACGGCTCAACCGTGAAATTGCAGTTGATACTGTTAGTCTTGAGTATACATGAGGTGGGCGGAATTTGTGG	d__Bacteria; p__Bacteroidota; c__Bacteroidia; o__Bacteroidales; f__Bacteroidaceae; g__Bacteroides_G; s__	1.0
TACGTAGGGGGCAAGCGTTGTCCGGAATTATTGGGCGTAAAGGGTTCGCAGGCGGAAATATAAGTCAGGTGTAAAAGGCGGAGGCTCAACCTCCGTAAGCATTTGAAACTATATTTCTTGAGATATGGAGAGGTAAGTGGAATTCCTAGT	d__Bacteria; p__Firmicutes_A; c__Clostridia_258483; o__Tissierellales; f__Peptoniphilaceae; g__Anaerosphaera_226805; s__Anaerosphaera stercorisuis	1.0
TACGTAGGTGGCAAGCGTTGTCCGGATTTATTGGGCGTAAAGCGAGCGCAGGCGGTCTTTTAAGTCTGATGTGAAAGCCCTCGGCTCAACCGAGGAAGGTCATTGGAAACTGGAGGACTTGAGTGCAGAAGAGGAGAGTGGAATTCCATG	d__Bacteria; p__Firmicutes_D; c__Bacilli; o__Lactobacillales; f__Vagococcaceae; g__Vagococcus_B; s__Vagococcus_B teuberi	1.0
TACAGAGGGTGCGAGCGTTAATCGGATTTACTGGGCGTAAAGCGTGCGTAGGCGGCTTTTTAAGTCGGATGTGAAATCCCTGAGCTTAACTTAGGAATTGCATTCGATACTGGGAAGCTAGAGTATGGGAGAGGATGGTAGAATTCCAGG	d__Bacteria; p__Proteobacteria; c__Gammaproteobacteria; o__Pseudomonadales_660879; f__Moraxellaceae; g__Acinetobacter; s__Acinetobacter johnsonii	1.0
TACGTAGGTGGCAAGCGTTGTCCGGAATTATTGGGCGTAAAGCGCACGCAGGCGGCCTTCTAAGTCTGATGTGAAATCCCACGGCTTAACCGTGGAAGGTCATTGGAAACTGGAAGGCTTGAGGATAGAAGAGGAAAGTGGAATTCCACG	d__Bacteria; p__Firmicutes_D; c__Bacilli; o__Bacillales_A; f__Planococcaceae; g__Savagea; s__Savagea sp009740415	1.0
TACGGAGGATCCGAGCGTTATCCGGATTTATTGGGTTTAAAGGGTGCGTAGGCGGGCCTGAAAGTCAGCTGTGAAAGTTAATAGCTCAACTATTAAATTGCAGTTGAAACTGTGGGTCTTGAGTGTACATGAGGTAAGCGGAATTTGTGG	d__Bacteria; p__Bacteroidota; c__Bacteroidia; o__Bacteroidales; f__Paludibacteraceae; g__Paludibacter; s__Paludibacter propionicigenes	1.0
TACGTAGGGGGCTAGCGTTGTCCGGAATTACTGGGCGTAAAGGGTTCGCAGGCGGAAATACAAGTCAGGTGTAAAAGGCGGAGGCTTAACCTCCGTAAGCATTTGAAACTGTATTTCTTGAGATATGGAGAGGCAAGTGGAATTCCTAGT	d__Bacteria; p__Firmicutes_A; c__Clostridia_258483; o__Tissierellales; f__Peptoniphilaceae; g__Anaerosphaera_226805; s__Anaerosphaera stercorisuis	1.0
TACAGAGGGTGCGAGCGTTAATCGGATTTACTGGGCGTAAAGCGTGCGTAGGCGGCTTTTTAAGTCGGATGTGAAATCCCCGAGCTTAACTTGGGAATTGCATTCGATACTGGGAAGCTAGAGTATGGGAGAGGATGGTAGAATTCCAGG	d__Bacteria; p__Proteobacteria; c__Gammaproteobacteria; o__Pseudomonadales_660879; f__Moraxellaceae; g__Acinetobacter; s__Acinetobacter gyllenbergii	1.0
TACGGAGGGTGCAAGCGTTAATCGGAATTACTGGGCGTAAAGGGCGCGTAGGTGGTATCTTAAGTTGGGTGTGAAATCCCCGGGCTCAACCTGGGAATTGCATCCAAAACTGGGGTGCTAGAGTATGGTAGAGGGTAGCGGAATTTCTGG	d__Bacteria; p__Proteobacteria; c__Gammaproteobacteria; o__Cardiobacteriales; f__Wohlfahrtiimonadaceae; g__Ignatzschineria; s__	1.0
TACAGAGGGTGCGAGCGTTAATCGGATTTACTGGGCGTAAAGCGTACGTAGGCGGCTTTTTAAGTCGGATGTGAAATCCCTGAGCTTAACTTAGGAATTGCATTCGATACTGGGAAGCTAGAGTATGGGAGAGGATGGTAGAATTCCAGG	d__Bacteria; p__Proteobacteria; c__Gammaproteobacteria; o__Pseudomonadales_660879; f__Moraxellaceae; g__Acinetobacter; s__Acinetobacter bouvetii	1.0
TACGTAGGTGGCAAGCGTTGTCCGGAATTATTGGGCGTAAAGCGCACGCAGGCGGCCTTTTAAGTCTGATGTGAAATCCCACGGCTTAACCGTGGAAGGTCATTGGAAACTGGAAGGCTTGAGGATAGAAGAGGAAAGTGGAATTCCACG	d__Bacteria; p__Firmicutes_D; c__Bacilli; o__Bacillales_A; f__Planococcaceae; g__Savagea; s__Savagea sp009740415	1.0
TACGGAGGATCCGAGCGTTATCCGGATTTATTGGGTTTAAAGGGTGCGTAGGCGGACTAGTAAGTCAGCTGTGAAAGTTAGTGGCTCAACCACTAAATTGCAGTTGAAACTGTTGGTCTTGAGTATACATGAGGTGAGCGGAATTTGTGG	d__Bacteria; p__Bacteroidota; c__Bacteroidia; o__Bacteroidales; f__Bacteroidaceae; g__Bacteroides_E; s__Bacteroides_E coprosuis	1.0
TACGAAGGGTGCAAGCGTTAATCGGAATTACTGGGCGTAAAGCGCGCGTAGGTGGTTTGTTAAGTTGGAAGTGAAAGCCCCGGGCTCAACCTGGGAATTGCTTTCAAAACTAGCAGGCTAGAGTACAGTAGAGGGTAGTGGAATTTCCTG	d__Bacteria; p__Proteobacteria; c__Gammaproteobacteria; o__Pseudomonadales_650611; f__Pseudomonadaceae; g__Oblitimonas; s__Oblitimonas alkaliphila	1.0
TACGGAGGATCCAAGCGTTATCCGGATTTATTGGGTTTAAAGGGTGCGTAGGCGGGAAAGGAAGTCAGTTGTGAAATTTTATGGCTCAACCATAAACTTGCAGTTGAAACTCTTTTTCTTGAGTACACATGAGGTGGGCGGAATTTGTGG	d__Bacteria; p__Bacteroidota; c__Bacteroidia; o__Bacteroidales; f__Bacteroidaceae; g__Bacteroides_E; s__	1.0
TACGTAGGTGGCAAGCGTTGTCCGGATTTATTGGGCGTAAAGCGAGCGCAGGCGGTTTCTTAAGTCTGATGTGAAAGCCCTCGGCTCAACCGAGGAAGGTCATTGGAAACTGGGGAACTTGAATGCAGAAGAGGAGAGTGGAATTCCATG	d__Bacteria; p__Firmicutes_D; c__Bacilli; o__Lactobacillales; f__Vagococcaceae; g__Vagococcus_B; s__Vagococcus_B fluvialis	1.0
TACGGGGGGTGCAAGCGTTAATCGGAATTACTGGGCGTAAAGGGCGCGTAGGCGGTTACTTAAGTTAGATGTGAAAGCCCCGGGCTCAACCTGGGAATTGCATTTAATACTGGGTAACTAGAGTGTGGTAGAGAGTAGCGGAATTTCTGG	d__Bacteria; p__Proteobacteria; c__Gammaproteobacteria; o__Cardiobacteriales; f__Wohlfahrtiimonadaceae; g__Wohlfahrtiimonas; s__Wohlfahrtiimonas chitiniclastica	1.0
TACGTAGGTGGCAAGCGTTGTCCGGATTTATTGGGCGTAAAGCGAGCGCAGGCGGTCTTTTAAGTCTGATGTGAAAGCCCTCGGCTCAACCGAGGAAGGTCATTGGAAACTGGGAGACTTGAGTGCAGAAGAGGAGAGTGGAATTCCATG	d__Bacteria; p__Firmicutes_D; c__Bacilli; o__Lactobacillales; f__Vagococcaceae; g__Vagococcus_B; s__	1.0
TACGGAGGGTGCAAGCGTTAATCGGAATTACTGGGCGTAAAGGGCGCGTAGGTGGTACTTTAAGTTGGGTGTGAAATCCCCGGGCTCAACCTGGGAATTGCATCCAAAACTGGGGTGCTAGAGTGTGGTAGAGGGTAGCGGAATTTCTGG	d__Bacteria; p__Proteobacteria; c__Gammaproteobacteria; o__Cardiobacteriales; f__Wohlfahrtiimonadaceae; g__Ignatzschineria; s__Ignatzschineria indica	1.0
TACGTAGGGGGCTAGCGTTGTCCGGAATTACTGGGCGTAAAGGGTTCGCAGGCGGAAATATAAGTCAGGTGTAAAAGGCGGAGGCTCAACCTCCGTAAGCATTTGAAACTATATTTCTTGAGATATGGAGAGGCAAGTGGAATTCCTAGT	d__Bacteria; p__Firmicutes_A; c__Clostridia_258483; o__Tissierellales; f__Peptoniphilaceae; g__Anaerosphaera_226805; s__Anaerosphaera stercorisuis	1.0
TACGGAGGGTGCAAGCGTTAATCGGAATTACTGGGCGTAAAGGGCGCGTAGGTGGTATCTTAAGTTGGGTGTGAAATCCCCGGGCTCAACCTGGGAATTGCATCCAAAACTGGGATGCTAGAGTGTGGTAGAGGGTAGCGGAATTTCTGG	d__Bacteria; p__Proteobacteria; c__Gammaproteobacteria; o__Cardiobacteriales; f__Wohlfahrtiimonadaceae; g__Ignatzschineria; s__Ignatzschineria larvae	1.0
